
score,episode reward,running reward,episode frames,total frames,Q values
130,44,44.0,165,165,7.711532
130,44,44.0,265,430,8.760769
320,80,56.0,497,927,9.334431
280,80,62.0,570,1497,9.716899
80,32,56.0,262,1759,10.043714
130,40,53.333333333333336,400,2159,10.013061
160,48,52.57142857142857,343,2502,10.040135
230,68,54.5,511,3013,9.886226
300,76,56.888888888888886,500,3513,9.827756
280,84,59.6,606,4119,9.652229
150,49,58.63636363636363,385,4504,9.664467
170,48,57.75,390,4894,9.730113
270,76,59.15384615384615,557,5451,9.826609
420,108,62.642857142857146,843,6294,10.041787
150,52,61.93333333333333,340,6634,10.229024
120,40,60.5625,278,6912,10.366035
500,124,64.29411764705883,662,7574,10.259904
260,76,64.94444444444444,578,8152,9.886185
230,72,65.3157894736842,631,8783,10.068615
50,9,62.5,156,8939,9.739155
630,160,67.14285714285714,1134,10073,10.112915
100,32,65.54545454545455,263,10336,11.0207
150,44,64.6086956521739,293,10629,11.362738
240,73,64.95833333333333,305,10934,11.294787
120,44,64.12,336,11270,11.4983425
140,42,63.26923076923077,360,11630,11.245651
250,84,64.03703703703704,422,12052,11.2397585
160,48,63.464285714285715,307,12359,11.376359
370,100,64.72413793103448,716,13075,11.411115
650,164,68.03333333333333,1237,14312,11.349375
80,24,66.61290322580645,92,14404,11.356397
180,60,66.40625,506,14910,11.285509
90,24,65.12121212121212,230,15140,11.159511
260,72,65.32352941176471,413,15553,11.139665
440,120,66.88571428571429,646,16199,11.138635
600,156,69.36111111111111,868,17067,11.218832
70,24,68.13513513513513,205,17272,11.349508
100,36,67.28947368421052,322,17594,11.080141
140,56,67.0,353,17947,11.105103
430,120,68.325,537,18484,11.130165
490,124,69.6829268292683,824,19308,11.096727
680,168,72.02380952380952,1261,20569,11.345996
60,22,70.86046511627907,226,20795,11.639545
680,168,73.06818181818181,1025,21820,11.586611
160,44,72.42222222222222,399,22219,11.595297
60,24,71.3695652173913,178,22397,11.617455
290,84,71.63829787234043,331,22728,11.717418
250,76,71.72916666666667,455,23183,11.525633
330,88,72.06122448979592,707,23890,11.651634
210,75,72.12,701,24591,11.819376
140,48,71.6470588235294,423,25014,11.878237
370,104,72.26923076923077,650,25664,11.837096
370,104,72.86792452830188,587,26251,11.631836
100,24,71.96296296296296,157,26408,11.644474
210,56,71.67272727272727,415,26823,11.533448
260,70,71.64285714285714,551,27374,11.774928
80,32,70.94736842105263,218,27592,11.636018
570,144,72.20689655172414,881,28473,11.735641
310,96,72.61016949152543,483,28956,11.584166
40,16,71.66666666666667,130,29086,11.556889
190,52,71.34426229508196,451,29537,11.676274
90,36,70.7741935483871,366,29903,11.870478
330,97,71.19047619047619,486,30389,12.217975
600,145,72.34375,855,31244,12.434866
190,64,72.21538461538462,333,31577,12.488298
240,76,72.27272727272727,490,32067,12.520435
320,88,72.50746268656717,581,32648,12.23634
130,46,72.11764705882354,303,32951,12.512229
90,36,71.59420289855072,248,33199,12.489988
190,64,71.48571428571428,479,33678,12.227694
170,56,71.26760563380282,414,34092,12.559527
510,128,72.05555555555556,829,34921,12.361926
250,74,72.08219178082192,483,35404,12.598795
310,96,72.4054054054054,573,35977,12.515671
310,92,72.66666666666667,710,36687,12.342163
510,131,73.4342105263158,830,37517,12.329368
220,64,73.31168831168831,593,38110,12.40143
60,24,72.67948717948718,230,38340,12.47085
30,12,71.9113924050633,130,38470,12.1836405
240,80,72.0125,469,38939,12.450918
110,32,71.51851851851852,296,39235,12.5081
490,128,72.20731707317073,922,40157,12.533057
70,28,71.67469879518072,159,40316,12.697957
110,40,71.29761904761905,273,40589,13.014544
50,18,70.67058823529412,94,40683,12.972741
160,44,70.36046511627907,341,41024,12.829896
250,80,70.47126436781609,555,41579,12.930643
340,104,70.85227272727273,680,42259,13.007602
450,119,71.3932584269663,853,43112,12.98515
430,114,71.86666666666666,854,43966,12.857815
370,101,72.18681318681318,658,44624,12.928284
170,52,71.96739130434783,349,44973,12.857787
210,57,71.80645161290323,308,45281,12.818769
150,44,71.51063829787235,302,45583,12.796959
290,88,71.6842105263158,476,46059,12.977024
160,54,71.5,397,46456,12.9790325
180,64,71.42268041237114,413,46869,12.998116
150,44,71.14285714285714,369,47238,12.788208
190,56,70.98989898989899,527,47765,12.892458
370,108,71.36,594,48359,12.988995
290,81,71.73,636,48995,13.023637
280,80,72.09,466,49461,12.950352
610,146,72.75,1245,50706,13.274834
320,88,72.83,517,51223,13.47266
580,146,73.97,802,52025,13.527942
180,60,74.17,474,52499,13.316685
120,39,74.08,365,52864,13.525329
260,71,74.11,495,53359,13.501026
120,44,73.79,196,53555,13.866138
580,152,74.47,1105,54660,13.453867
110,32,74.3,358,55018,13.434502
470,116,74.98,1038,56056,13.314569
510,136,75.58,898,56954,13.374478
80,28,74.78,276,57230,13.333503
440,116,75.42,824,58054,13.400274
180,52,75.54,431,58485,13.606888
70,28,74.58,251,58736,13.415927
50,20,74.02,195,58931,13.402784
570,140,74.7,972,59903,13.490804
450,119,75.8,819,60722,13.591971
610,150,75.7,981,61703,13.747844
470,116,76.54,720,62423,13.608122
100,32,76.42,437,62860,13.831171
340,80,76.49,636,63496,13.681877
530,136,77.41,1119,64615,13.495892
250,72,77.71,455,65070,13.401473
100,32,77.19,240,65310,13.685714
180,56,77.27,374,65684,13.521007
650,164,77.91,1253,66937,13.574008
500,132,77.59,994,67931,13.47739
460,116,78.51,685,68616,13.327271
590,144,79.35,912,69528,13.474041
380,98,80.09,693,70221,13.440447
150,44,79.81,406,70627,13.629606
80,32,78.93,338,70965,13.629792
720,176,79.13,1279,72244,13.595573
340,92,79.81,583,72827,13.527058
550,148,80.93,1162,73989,13.495543
540,136,81.73,1075,75064,13.441677
450,116,81.69,728,75792,13.669822
180,53,80.98,275,76067,13.655625
320,92,80.22,547,76614,13.693284
150,48,80.48,289,76903,13.619023
340,100,79.8,494,77397,13.927361
220,72,80.08,516,77913,13.752212
670,168,81.52,1017,78930,13.739314
190,56,81.24,434,79364,13.808576
320,100,81.48,614,79978,13.745639
570,152,82.12,853,80831,14.057875
190,49,81.86,377,81208,14.009168
390,112,82.5,813,82021,14.018004
170,56,82.02,407,82428,14.133877
180,44,81.42,200,82628,14.125996
140,40,81.58,357,82985,14.012749
280,69,81.71,508,83493,13.976908
240,64,81.65,605,84098,14.174091
250,80,82.13,366,84464,14.089969
230,72,81.41,611,85075,13.939741
60,16,80.61,152,85227,14.078
160,44,80.89,330,85557,14.07751
50,20,80.57,239,85796,14.043659
560,142,81.63,841,86637,14.050049
320,86,81.52,442,87079,14.001699
180,62,80.69,509,87588,13.928694
520,129,81.34,734,88322,13.927452
340,91,81.49,644,88966,13.967005
150,40,81.01,478,89444,14.009253
60,24,80.79,205,89649,14.019392
150,44,80.87,369,90018,13.862228
280,76,80.99,475,90493,14.330293
210,64,81.07,532,91025,14.362656
260,76,80.55,373,91398,14.324234
330,88,80.69,687,92085,14.332574
40,16,79.89,96,92181,14.770985
550,142,80.39,977,93158,14.36089
210,57,79.65,476,93634,14.334446
170,51,79.52,447,94081,14.572777
390,104,80.32,515,94596,14.450454
280,80,81.0,481,95077,14.3694
480,124,81.44,1031,96108,14.548108
390,108,82.2,680,96788,14.510836
370,96,81.88,529,97317,14.553996
250,72,82.32,366,97683,14.641671
460,124,83.16,669,98352,14.471784
490,124,84.22,781,99133,14.603914
380,104,84.82,835,99968,14.616572
420,120,85.22,1036,101004,14.872199
110,42,84.6,452,101456,14.9393215
600,136,84.77,1057,102513,14.892947
150,48,84.11,254,102767,14.979579
450,116,84.26,649,103416,14.836705
910,232,86.06,1634,105050,14.856941
690,164,87.13,1307,106357,14.642331
370,108,87.77,580,106937,14.675224
130,48,87.37,336,107273,14.5933485
180,56,87.39,329,107602,14.529716
480,120,87.95,904,108506,14.639019
410,112,88.63,774,109280,14.503211
520,136,89.43,958,110238,14.650599
440,128,89.63,779,111017,14.794855
220,52,89.34,465,111482,14.832849
200,60,89.14,378,111860,15.066334
340,96,88.64,584,112444,14.943157
240,64,88.4,648,113092,14.64624
210,72,87.66,472,113564,14.8757515
260,84,87.9,477,114041,14.78549
290,88,88.39,522,114563,14.9059305
130,41,88.09,399,114962,14.697832
500,136,89.01,707,115669,14.643515
150,56,88.05,454,116123,14.668775
130,40,88.13,267,116390,14.513997
260,80,87.77,534,116924,14.577935
70,24,86.65,165,117089,14.762239
90,32,86.69,278,117367,14.619554
400,112,86.65,1002,118369,14.645682
490,124,87.37,894,119263,14.653466
60,24,87.33,194,119457,15.025882
460,120,88.33,784,120241,14.806746
480,127,88.2,892,121133,15.04883
380,108,88.09,836,121969,15.155283
200,55,87.14,390,122359,15.19961
240,72,86.7,530,122889,15.062091
290,88,87.26,663,123552,15.056325
110,36,86.82,307,123859,15.11007
460,108,86.54,692,124551,15.078671
60,16,85.98,107,124658,15.368564
300,82,86.48,587,125245,15.062076
460,120,87.12,670,125915,15.105639
50,20,85.68,142,126057,15.252624
280,72,85.08,559,126616,15.051632
770,188,85.8,1303,127919,15.178534
130,44,84.8,284,128203,15.1330805
50,20,84.02,140,128343,14.913606
190,52,84.1,412,128755,15.152455
370,96,84.74,751,129506,15.042841
370,112,84.1,678,130184,15.183092
110,36,83.54,249,130433,15.0613985
290,83,82.89,642,131075,15.1011
30,12,81.65,194,131269,15.013774
300,96,81.45,634,131903,15.061493
190,56,81.48,332,132235,14.918316
630,160,82.16,1111,133346,14.992127
50,20,81.88,137,133483,15.399911
600,148,82.36,787,134270,14.949866
170,44,82.08,203,134473,15.096209
180,44,80.84,364,134837,14.985884
320,84,81.12,490,135327,15.001086
300,88,81.0,719,136046,14.95836
190,60,80.08,474,136520,14.882477
190,56,80.15,412,136932,14.842714
430,112,80.15,798,137730,14.772877
160,47,80.06,387,138117,14.713664
680,169,81.31,1245,139362,14.673323
380,96,81.87,637,139999,14.775658
260,80,81.98,594,140593,14.879355
520,136,82.7,857,141450,15.110617
360,92,82.82,494,141944,14.957868
140,44,82.54,332,142276,15.083569
260,79,83.17,475,142751,14.8089905
280,72,83.45,330,143081,15.07467
330,92,84.17,541,143622,15.084176
570,144,84.19,858,144480,15.024245
140,39,83.72,283,144763,15.025325
250,76,83.86,594,145357,14.98644
450,120,83.77,884,146241,14.964489
300,76,83.62,642,146883,14.990992
200,60,83.82,462,147345,15.227681
620,164,85.22,966,148311,15.178503
610,148,86.26,1240,149551,15.247905
190,48,85.98,345,149896,15.161001
360,96,86.3,608,150504,15.229605
170,50,86.04,298,150802,15.45962
140,44,85.6,364,151166,15.441331
360,92,86.36,902,152068,15.403215
100,36,85.3,300,152368,15.315985
740,180,86.53,1190,153558,15.5121765
330,87,86.89,528,154086,15.599312
490,120,87.05,1367,155453,15.499128
60,22,86.47,89,155542,15.2389765
110,44,85.67,409,155951,15.44702
550,137,85.96,1166,157117,15.322056
680,168,86.68,1649,158766,15.374974
700,176,87.72,1460,160226,15.262995
380,92,87.4,908,161134,15.109863
290,84,87.0,628,161762,15.129026
130,44,86.4,409,162171,15.264285
120,32,85.52,200,162371,15.248801
280,76,85.86,610,162981,15.243997
180,56,85.06,429,163410,15.252752
370,92,85.5,902,164312,15.376698
170,55,84.89,384,164696,15.331105
270,76,83.33,588,165284,15.185424
100,28,81.97,269,165553,14.965461
20,8,80.97,148,165701,14.86535
770,188,82.37,1499,167200,15.116979
390,108,82.89,806,168006,15.1705475
440,116,82.85,889,168895,15.125896
400,107,82.8,976,169871,15.115398
210,72,82.16,563,170434,15.074861
460,121,82.09,934,171368,15.22846
240,68,82.25,668,172036,15.365227
110,36,82.01,307,172343,15.586971
250,68,81.73,475,172818,15.38536
370,98,82.07,712,173530,15.281854
130,40,81.75,319,173849,15.440802
390,107,81.98,974,174823,15.259116
310,78,81.88,584,175407,15.265865
130,36,81.83,277,175684,15.3312025
80,24,80.71,298,175982,15.318415
570,140,81.55,1249,177231,15.276659
320,80,81.95,770,178001,15.295932
120,39,81.54,363,178364,15.414734
460,116,82.46,951,179315,15.361868
210,52,82.66,516,179831,15.406269
30,8,81.62,232,180063,15.360149
340,92,81.3,871,180934,15.714152
430,110,82.16,1204,182138,15.728333
60,24,81.2,294,182432,15.724578
350,96,80.89,862,183294,15.6814
230,60,80.41,580,183874,15.598599
220,64,80.5,589,184463,15.535677
170,52,80.3,371,184834,15.537749
870,212,81.54,1987,186821,15.586427
720,116,82.34,894,187715,15.4452915
210,60,81.86,439,188154,15.421822
190,68,82.38,391,188545,15.391997
730,180,83.36,1220,189765,15.542584
750,136,83.52,1169,190934,15.649868
370,92,84.24,700,191634,15.760058
360,96,84.48,851,192485,15.854091
60,16,82.76,116,192601,15.844134
300,88,83.2,598,193199,15.79989
150,40,83.4,359,193558,15.733316
290,80,83.68,715,194273,15.713433
550,132,84.04,949,195222,15.735711
590,152,84.44,1074,196296,15.772876
160,40,84.48,275,196571,15.9385195
180,56,84.21,425,196996,15.746082
90,36,84.45,184,197180,15.978306
60,20,83.69,196,197376,15.815799
540,141,84.54,1047,198423,15.810151
300,77,83.71,616,199039,15.935087
90,32,83.83,408,199447,15.897451
220,64,82.99,479,199926,15.849806
330,84,83.39,588,200514,16.096895
460,117,84.12,712,201226,16.096893
120,32,83.6,317,201543,15.95149
320,81,83.53,575,202118,16.093636
770,188,84.81,1311,203429,15.981197
440,111,85.36,1145,204574,16.030064
500,133,85.57,982,205556,16.116655
120,36,85.46,288,205844,15.976961
310,80,84.57,748,206592,16.06799
360,96,84.57,878,207470,16.083128
480,124,85.01,949,208419,16.100626
200,52,84.17,401,208820,16.19534
80,32,83.57,191,209011,15.955085
210,64,83.77,455,209466,16.164692
120,36,83.34,212,209678,16.149464
190,52,83.14,358,210036,16.10303
470,116,83.38,836,210872,16.30622
190,60,82.54,474,211346,16.34708
120,41,82.56,378,211724,16.43277
450,116,82.96,925,212649,16.422865
220,56,82.32,583,213232,16.446236
300,84,82.4,524,213756,16.335314
240,84,82.64,522,214278,16.37342
410,112,82.12,947,215225,16.496908
420,102,81.66,832,216057,16.38208
450,120,82.38,818,216875,16.545855
460,111,82.53,1060,217935,16.484196
420,116,83.19,918,218853,16.421171
380,100,83.75,863,219716,16.51286
110,32,83.15,390,220106,16.629572
90,36,83.15,660,220766,16.771141
300,84,82.19,711,221477,16.584778
270,69,82.01,614,222091,16.655905
660,168,82.49,1129,223220,16.762789
90,32,82.59,232,223452,16.51736
90,32,82.47,246,223698,16.610239
100,36,81.46,238,223936,16.799585
320,80,80.58,712,224648,16.683216
580,151,80.33,1244,225892,16.740454
240,64,80.05,566,226458,16.634249
420,112,80.33,866,227324,16.647593
150,48,80.37,333,227657,16.601114
670,164,81.69,1447,229104,16.586859
320,80,81.73,698,229802,16.57629
100,32,81.49,213,230015,16.463734
490,114,81.71,1161,231176,16.4512
190,60,81.76,471,231647,16.316126
610,152,82.52,1391,233038,16.452644
160,56,82.8,356,233394,16.340881
340,92,83.64,593,233987,16.554993
450,105,82.81,682,234669,16.527817
350,100,82.73,941,235610,16.373245
470,116,82.73,1265,236875,16.535353
220,60,82.26,502,237377,16.53354
240,72,82.26,744,238121,16.437986
330,96,82.01,806,238927,16.456833
700,176,83.09,1282,240209,16.575764
1290,284,85.57,1819,242028,16.715218
1320,176,86.65,1371,243399,16.774134
240,72,86.39,572,243971,16.957119
390,104,87.03,855,244826,16.720682
410,116,87.12,685,245511,16.576612
400,104,87.38,910,246421,16.646458
440,120,88.22,809,247230,16.737099
370,100,88.98,843,248073,16.755796
270,76,88.34,452,248525,16.699003
570,148,89.02,836,249361,16.821476
200,52,89.15,421,249782,16.735867
80,24,88.23,272,250054,16.883102
90,32,88.03,232,250286,17.111107
160,52,88.47,430,250716,17.153353
250,72,88.27,543,251259,17.168386
80,32,87.49,287,251546,16.98692
600,151,88.76,1185,252731,16.994574
80,30,88.1,292,253023,17.06661
290,80,88.3,541,253564,16.87566
70,28,87.94,279,253843,17.17384
290,88,88.3,640,254483,16.959763
410,108,87.26,713,255196,16.945633
70,28,86.38,194,255390,16.729559
540,136,87.14,1370,256760,16.954542
370,100,87.46,786,257546,16.94456
240,72,86.38,538,258084,16.83505
320,96,85.98,716,258800,16.824621
260,60,85.66,577,259377,16.94484
250,65,85.35,375,259752,16.78331
220,71,85.9,364,260116,16.670324
200,56,85.58,426,260542,16.526028
420,112,86.3,661,261203,16.571583
700,168,87.18,1489,262692,16.592787
280,76,86.62,487,263179,16.700659
250,76,85.86,419,263598,16.411661
370,92,86.38,668,264266,16.491835
520,136,87.18,1057,265323,16.554546
360,92,87.74,785,266108,16.610113
270,68,88.22,583,266691,16.590984
310,76,87.57,785,267476,16.549204
180,52,87.32,426,267902,16.677292
170,48,87.48,452,268354,16.733475
370,104,87.88,635,268989,16.453863
30,12,87.16,181,269170,16.631384
560,132,87.31,1353,270523,16.47356
290,88,87.87,858,271381,16.419155
240,80,87.86,765,272146,16.362553
350,100,86.98,744,272890,16.435472
510,129,87.16,780,273670,16.463522
230,68,86.51,533,274203,16.470043
170,48,86.63,367,274570,16.298853
640,160,87.43,941,275511,16.419945
200,60,87.07,418,275929,16.45562
650,156,87.39,1524,277453,16.450422
60,16,87.03,191,277644,16.485924
150,44,87.15,475,278119,16.310972
430,108,87.59,1006,279125,16.397116
400,100,88.23,1040,280165,16.329376
300,96,88.67,606,280771,16.39844
530,132,88.83,1742,282513,16.54692
180,48,88.71,793,283306,16.32934
610,156,89.86,2011,285317,16.270336
130,36,89.06,324,285641,16.146143
590,149,89.99,1659,287300,16.16817
310,80,89.95,1330,288630,16.034294
500,128,90.39,1404,290034,16.015654
600,152,90.79,1747,291781,16.3014
170,44,90.21,622,292403,16.28625
380,100,90.01,835,293238,16.27053
510,124,90.14,1487,294725,16.380833
280,73,89.71,983,295708,16.404709
380,90,89.61,1249,296957,16.307526
350,88,90.17,1102,298059,16.375769
440,114,90.95,1426,299485,16.397726
770,184,91.95,2007,301492,16.4711
600,148,92.74,1478,302970,16.482403
70,20,91.26,143,303113,16.558516
100,32,91.26,476,303589,16.456133
440,115,92.09,912,304501,16.36883
220,68,92.41,550,305051,16.50833
60,24,91.85,353,305404,16.577835
490,120,91.54,1392,306796,16.456068
630,164,92.54,1181,307977,16.51421
520,132,92.74,1343,309320,16.635782
300,100,93.26,648,309968,16.650574
600,154,93.16,956,310924,16.680288
570,156,93.92,1315,312239,16.69385
380,112,94.72,1113,313352,16.749277
140,45,94.03,233,313585,16.987503
270,68,94.11,462,314047,16.791077
210,60,93.19,713,314760,16.95643
630,153,94.16,1412,316172,16.956244
300,85,94.09,687,316859,16.855244
320,80,93.84,934,317793,16.929014
420,111,93.95,909,318702,16.922209
140,40,93.19,498,319200,16.95863
430,120,93.79,1179,320379,16.813293
170,43,93.5,321,320700,16.86106
290,82,93.36,542,321242,16.921202
410,112,92.72,942,322184,16.845257
580,148,91.36,884,323068,16.830091
140,44,90.04,304,323372,16.816233
280,71,90.03,688,324060,16.737103
600,156,90.55,1273,325333,16.724398
510,132,90.71,1414,326747,16.69243
620,160,91.27,1289,328036,16.735912
370,99,91.06,871,328907,16.822279
410,104,91.1,1165,330072,16.772614
320,84,91.18,630,330702,16.807667
90,24,89.94,185,330887,16.800709
660,168,91.1,1511,332398,16.74334
310,88,91.74,604,333002,16.735207
170,52,91.94,463,333465,16.710163
400,112,92.54,802,334267,16.722101
440,124,93.06,703,334970,16.786392
540,134,94.08,1158,336128,16.935335
440,108,93.65,862,336990,16.771389
140,40,93.75,450,337440,16.774294
820,196,94.91,1653,339093,16.82916
300,80,95.43,1084,340177,16.83692
170,56,95.11,423,340600,17.027136
400,104,95.07,845,341445,17.048569
20,8,94.87,145,341590,17.014359
140,36,93.87,300,341890,17.184145
200,60,93.47,385,342275,17.032013
240,64,93.39,553,342828,17.043152
110,36,92.79,435,343263,17.104944
120,35,92.54,353,343616,17.024477
540,144,93.33,1120,344736,17.121557
490,128,93.9,877,345613,17.06944
690,176,95.1,1223,346836,17.058376
500,134,95.32,1004,347840,17.053066
120,44,94.08,334,348174,16.969555
410,112,94.44,661,348835,17.093307
100,32,94.0,479,349314,17.027914
400,100,94.08,840,350154,17.252714
130,48,93.2,293,350447,17.553934
590,156,93.84,1179,351626,17.416975
350,99,94.15,906,352532,17.579344
670,168,95.07,1279,353811,17.539915
210,68,95.23,567,354378,17.573677
280,78,95.53,719,355097,17.509762
620,156,96.05,1108,356205,17.66831
320,88,96.81,592,356797,17.584282
300,84,96.33,755,357552,17.661716
130,28,95.73,303,357855,17.621275
120,40,95.33,463,358318,17.577387
610,152,95.85,1362,359680,17.50847
510,136,95.92,884,360564,17.444494
260,80,96.04,644,361208,17.454872
470,128,96.84,729,361937,17.535482
310,95,96.19,795,362732,17.514029
260,72,96.31,618,363350,17.58791
650,168,96.43,1400,364750,17.529623
510,136,97.63,986,365736,17.501896
250,88,98.07,525,366261,17.359278
90,28,97.27,420,366681,17.506706
160,56,96.83,369,367050,17.450857
110,40,96.27,382,367432,17.276327
60,16,95.11,170,367602,17.514988
220,68,95.31,391,367993,17.202618
370,108,94.83,833,368826,17.378454
50,16,94.63,138,368964,17.2996
370,96,94.1,612,369576,17.419527
50,20,93.5,161,369737,17.303162
390,100,93.22,720,370457,17.513699
90,32,92.02,138,370595,17.694672
180,55,92.13,515,371110,17.785475
410,116,92.29,891,372001,17.73636
310,91,91.96,666,372667,17.73699
550,144,92.67,1018,373685,17.66716
150,56,92.33,479,374164,17.644897
360,94,92.39,717,374881,17.6792
230,72,91.97,491,375372,17.772268
510,136,91.49,1142,376514,17.855791
300,84,90.85,605,377119,17.916647
360,104,91.69,942,378061,17.703054
470,114,92.51,944,379005,17.66052
110,36,91.72,278,379283,17.730192
130,44,91.48,290,379573,17.589756
110,40,91.64,245,379818,17.686747
50,20,90.64,186,380004,17.729578
310,88,89.88,677,380681,18.011652
130,40,88.96,346,381027,17.936972
400,112,89.08,850,381877,18.068007
80,20,87.74,207,382084,18.050886
190,64,86.82,431,382515,17.997034
320,96,86.66,829,383344,17.939226
480,120,87.41,1542,384886,17.813435
510,136,88.09,1613,386499,17.777912
210,52,88.01,382,386881,17.708645
260,68,87.16,610,387491,17.674189
380,100,87.31,937,388428,17.479149
320,92,87.43,1125,389553,17.636787
340,94,87.26,1050,390603,17.589113
350,100,87.86,664,391267,17.697552
170,56,87.22,542,391809,17.42701
240,64,87.43,899,392708,17.56409
280,80,87.41,318,393026,17.523499
380,100,87.29,813,393839,17.473091
390,108,86.89,872,394711,17.627687
220,68,87.13,575,395286,17.637585
430,112,87.54,1191,396477,17.61779
160,48,86.46,353,396830,17.728954
150,52,85.66,438,397268,17.787432
400,108,85.14,1415,398683,17.634604
410,106,85.21,1456,400139,17.77918
670,172,85.89,1467,401606,17.591143
240,64,85.69,660,402266,17.670574
90,20,85.65,178,402444,17.803434
140,48,84.45,371,402815,17.609283
260,84,84.41,941,403756,17.737967
590,154,85.43,1286,405042,17.773127
80,24,84.55,177,405219,17.659018
670,165,84.96,1314,406533,17.755371
370,91,84.53,801,407334,17.648375
440,112,84.57,956,408290,17.883415
220,64,84.81,607,408897,17.72162
440,120,84.05,1494,410391,17.59071
280,80,84.05,735,411126,17.677446
460,124,84.73,1203,412329,17.77877
220,72,84.41,314,412643,17.744827
490,120,85.53,1261,413904,17.69979
410,104,86.21,1162,415066,17.634224
520,128,86.89,1576,416642,17.699848
260,71,86.96,788,417430,17.670689
420,112,87.72,1186,418616,17.63719
90,27,87.64,175,418791,17.562029
310,84,87.04,1133,419924,17.471186
320,96,86.72,898,420822,17.442623
170,56,85.52,344,421166,17.54929
260,76,84.94,952,422118,17.510054
60,24,84.74,161,422279,17.443954
580,148,85.1,1286,423565,17.590572
210,60,85.38,459,424024,17.643955
330,82,85.2,758,424782,17.440332
400,108,85.8,760,425542,17.614195
390,108,85.32,877,426419,17.68315
530,136,85.69,1329,427748,17.625597
180,48,84.49,369,428117,17.912813
170,64,84.45,628,428745,17.665497
200,55,84.22,479,429224,17.828175
140,44,83.1,353,429577,17.650713
700,176,83.98,1691,431268,17.957582
340,88,84.02,613,431881,18.096354
240,64,84.38,656,432537,18.0446
150,56,84.54,565,433102,18.109554
170,52,83.54,290,433392,17.848925
310,88,83.06,781,434173,17.997736
200,56,82.82,749,434922,18.050941
480,124,82.78,1115,436037,17.951878
380,98,82.81,653,436690,18.057915
100,32,82.41,326,437016,18.069075
130,48,81.21,417,437433,18.145386
240,84,80.69,554,437987,18.259516
210,68,80.49,546,438533,18.196728
320,96,81.17,783,439316,18.223793
120,44,81.05,320,439636,18.149588
620,156,82.21,1580,441216,18.338167
340,90,82.95,873,442089,18.3318
130,27,82.54,291,442380,18.235588
110,36,81.82,309,442689,18.34234
70,24,81.9,143,442832,18.146633
520,124,82.18,1339,444171,18.23095
420,104,83.02,1412,445583,18.2114
380,100,83.02,1206,446789,18.103855
170,48,83.18,358,447147,18.087759
450,108,83.71,1498,448645,18.074799
160,44,82.99,382,449027,17.95124
520,136,83.44,998,450025,17.813799
630,156,83.56,1168,451193,17.791294
170,52,83.52,535,451728,17.689936
380,100,83.58,728,452456,17.79398
320,100,83.86,965,453421,17.674948
130,45,82.95,299,453720,17.746735
380,100,83.11,831,454551,17.923977
370,108,83.15,775,455326,17.72686
280,84,82.85,496,455822,17.876863
110,44,82.93,361,456183,18.055038
130,37,82.86,295,456478,17.935223
440,108,83.54,676,457154,17.995583
430,116,84.5,732,457886,18.11342
480,128,84.9,860,458746,18.265368
160,40,84.9,389,459135,18.105547
630,153,85.31,1363,460498,18.124052
720,180,86.91,1539,462037,18.43021
560,140,87.67,1384,463421,18.552113
310,88,87.59,617,464038,18.425638
410,104,87.43,1051,465089,18.569328
240,64,86.71,520,465609,18.548069
300,80,86.99,841,466450,18.436787
550,148,87.79,1131,467581,18.375282
400,100,87.79,942,468523,18.33208
440,112,87.99,863,469386,18.255413
380,96,88.01,677,470063,18.337782
180,53,87.54,424,470487,18.115654
500,128,88.26,860,471347,18.118294
600,149,89.11,1191,472538,18.214594
490,136,89.67,879,473417,18.219557
660,164,90.31,1289,474706,18.275658
520,124,90.47,1354,476060,18.24876
750,184,91.63,1631,477691,18.221046
500,132,91.83,1587,479278,18.175657
300,88,92.23,994,480272,18.36996
440,118,92.89,1095,481367,18.353525
270,88,92.69,515,481882,18.38238
10,4,91.67,50,481932,18.677269
170,64,90.59,366,482298,18.562414
230,72,90.67,449,482747,18.45265
210,64,91.11,537,483284,18.385319
370,100,91.63,656,483940,18.426311
360,96,91.75,695,484635,18.483614
310,80,91.01,576,485211,18.258495
250,76,91.53,474,485685,18.443583
440,116,91.04,679,486364,18.330282
690,176,91.89,1120,487484,18.512455
480,124,92.01,861,488345,18.583097
530,132,92.69,1416,489761,18.488455
580,152,93.01,1433,491194,18.640612
170,52,92.73,355,491549,18.74415
170,56,92.05,300,491849,18.790445
100,31,91.64,138,491987,19.0349
210,60,91.04,372,492359,18.815128
190,64,90.64,479,492838,18.876606
100,28,89.64,291,493129,18.742483
370,96,89.89,867,493996,18.841951
280,69,89.46,404,494400,18.831232
480,128,90.47,1352,495752,18.776873
210,56,90.19,802,496554,18.701878
540,134,90.57,1302,497856,18.653507
40,16,90.17,192,498048,18.440683
420,114,90.55,1069,499117,18.536736
360,88,91.19,953,500070,18.467266
50,20,89.91,199,500269,18.724165
520,136,90.67,994,501263,18.468517
140,43,90.28,441,501704,18.595114
250,76,89.96,665,502369,18.629105
290,72,89.6,459,502828,18.476538
220,60,88.84,457,503285,18.552687
100,36,88.72,326,503611,18.588459
540,143,89.51,1333,504944,18.617378
320,92,89.88,678,505622,18.445618
600,156,91.0,1598,507220,18.512556
70,27,89.51,275,507495,18.52131
340,95,89.58,866,508361,18.651442
70,20,89.14,259,508620,18.562569
160,48,89.06,457,509077,18.68638
210,64,89.18,589,509666,18.710148
50,20,88.5,182,509848,18.577436
320,92,88.86,909,510757,18.618757
220,76,88.38,684,511441,18.537712
150,52,87.92,505,511946,18.592403
180,56,88.16,298,512244,18.558958
140,44,88.12,393,512637,18.67131
340,96,88.24,1030,513667,18.453873
110,28,87.84,197,513864,18.862364
620,160,88.48,1339,515203,18.459667
70,28,88.32,211,515414,18.429342
610,156,88.32,1722,517136,18.458435
230,76,88.18,706,517842,18.49888
180,44,88.35,399,518241,18.60913
290,84,88.83,642,518883,18.377678
50,20,88.79,189,519072,18.691233
410,104,88.59,995,520067,18.46402
160,48,88.03,473,520540,18.577028
320,100,88.03,941,521481,18.715698
390,112,88.67,731,522212,18.688961
380,104,88.63,647,522859,18.733934
100,32,88.51,309,523168,18.88789
470,132,88.47,939,524107,18.757198
100,28,87.19,409,524516,18.835243
130,40,87.07,431,524947,18.753195
340,96,87.03,845,525792,18.69998
140,52,86.55,482,526274,18.779913
460,120,87.3,1147,527421,18.837992
140,44,86.74,439,527860,18.752638
410,109,86.75,898,528758,18.88387
120,32,86.23,530,529288,18.83317
740,180,87.59,1600,530888,18.846037
300,80,88.02,1078,531966,18.858847
290,76,87.7,828,532794,18.879642
220,56,87.1,820,533614,18.91772
610,152,87.34,1388,535002,18.68446
370,100,87.94,1289,536291,18.617249
40,8,86.49,109,536400,18.64511
270,68,85.37,418,536818,18.630571
480,128,85.25,1469,538287,18.634127
370,92,85.29,1147,539434,18.51709
210,56,84.81,586,540020,18.376156
310,76,84.93,1082,541102,18.466341
80,28,84.41,150,541252,18.513489
90,32,83.25,464,541716,18.676395
150,42,82.67,620,542336,18.500504
430,120,82.75,1003,543339,18.465708
220,56,82.35,622,543961,18.374907
520,132,83.14,1478,545439,18.488348
120,40,82.26,496,545935,18.52387
350,96,81.73,917,546852,18.648
490,124,81.61,1169,548021,18.533842
590,152,81.49,1454,549475,18.465237
290,76,81.01,668,550143,18.59068
180,52,79.69,416,550559,18.703972
300,88,79.25,776,551335,18.702473
440,128,79.65,1011,552346,18.747938
160,48,78.95,384,552730,18.860254
570,140,79.47,1121,553851,18.92041
190,72,80.15,448,554299,19.046453
230,68,80.19,838,555137,19.065552
670,168,81.15,1318,556455,19.049747
600,156,82.07,1521,557976,19.012592
250,64,81.71,513,558489,19.151573
220,68,81.43,581,559070,19.093801
200,56,81.19,708,559778,19.129192
160,40,80.83,188,559966,19.123375
280,76,80.43,684,560650,19.515577
300,88,79.55,804,561454,19.436434
370,108,79.39,720,562174,19.663643
20,8,78.15,47,562221,19.23707
90,28,76.91,291,562512,19.824816
270,92,77.31,711,563223,19.578835
160,56,77.31,491,563714,19.625774
120,32,77.32,290,564004,19.71333
180,52,77.24,714,564718,19.693956
190,48,77.08,273,564991,19.700165
100,40,77.2,343,565334,19.589071
290,76,77.0,750,566084,19.664312
60,24,76.55,219,566303,19.814457
500,132,76.59,1007,567310,19.795652
400,112,77.15,1079,568389,19.7576
60,24,76.05,146,568535,20.02002
310,84,76.73,699,569234,19.755146
110,28,75.87,300,569534,19.843594
330,96,75.95,694,570228,19.903036
510,132,77.07,1090,571318,19.965332
280,72,76.43,532,571850,20.069328
110,40,76.4,320,572170,20.035746
600,148,77.12,1376,573546,19.924376
230,64,77.04,405,573951,19.864197
100,32,76.76,301,574252,19.904621
260,79,77.19,679,574931,20.011051
220,64,76.4,489,575420,19.979368
540,140,76.88,1027,576447,19.95275
290,80,76.12,522,576969,19.985558
530,140,77.25,745,577714,20.06801
570,152,77.82,745,578459,19.856337
120,36,77.98,255,578714,20.091005
20,8,77.58,94,578808,20.338465
200,60,77.54,317,579125,20.13574
460,128,78.62,833,579958,19.984735
180,64,78.34,687,580645,20.0019
190,64,78.22,510,581155,19.786049
310,84,78.54,511,581666,19.898172
230,64,78.62,384,582050,19.962934
350,96,79.14,606,582656,19.924217
70,24,78.42,163,582819,20.012112
240,72,78.86,692,583511,19.999378
320,96,78.22,623,584134,20.010754
250,72,78.66,433,584567,20.055939
110,32,77.42,179,584746,20.04238
360,93,77.59,435,585181,20.117403
140,44,77.59,214,585395,20.087044
220,68,77.43,355,585750,20.089264
210,60,77.83,351,586101,20.010338
270,80,77.59,405,586506,20.122648
320,88,77.99,423,586929,20.130587
40,13,77.12,104,587033,20.298943
270,84,76.84,452,587485,20.264246
560,151,77.31,934,588419,20.180702
120,36,77.35,223,588642,20.00596
130,44,76.47,272,588914,20.469421
220,69,76.88,334,589248,20.15465
770,184,78.32,1687,590935,20.194353
350,96,78.32,705,591640,20.200325
470,127,79.07,1021,592661,20.221575
410,116,79.03,729,593390,20.1959
510,132,79.91,964,594354,20.162409
260,68,79.5,574,594928,20.144287
250,72,79.9,592,595520,20.06821
460,124,79.34,882,596402,20.122223
120,40,78.94,354,596756,19.883999
580,155,79.73,1031,597787,20.04283
210,64,79.81,510,598297,19.869097
360,92,79.21,843,599140,19.901735
390,112,79.33,1177,600317,19.929289
620,156,80.81,1266,601583,20.035473
40,12,80.25,139,601722,19.865839
330,84,79.81,578,602300,20.034988
250,64,79.53,627,602927,19.962265
260,84,79.81,629,603556,19.903696
370,95,80.0,839,604395,19.991228
150,47,80.19,480,604875,19.976326
570,140,81.27,1388,606263,19.878592
120,40,81.25,317,606580,19.931675
110,40,80.45,345,606925,19.93761
220,64,80.53,502,607427,19.977713
320,99,80.2,719,608146,19.833908
330,96,80.76,609,608755,19.79243
660,164,81.44,1444,610199,19.86449
440,120,81.4,579,610778,19.861984
360,104,80.92,791,611569,19.92366
140,48,80.64,289,611858,19.8932
700,176,81.88,973,612831,20.001995
510,136,82.36,968,613799,20.14201
720,176,82.84,2166,615965,20.058537
120,48,82.84,320,616285,20.126436
270,68,82.12,427,616712,20.064314
720,180,83.2,1902,618614,20.021317
770,188,84.4,1684,620298,19.922144
210,68,83.4,357,620655,19.837627
370,103,82.87,664,621319,20.040045
250,73,82.96,456,621775,19.82752
130,44,82.72,423,622198,20.04283
120,40,82.56,316,622514,19.9887
210,67,82.83,324,622838,20.065823
50,16,82.23,181,623019,20.186697
410,110,82.45,763,623782,20.153467
240,80,82.17,481,624263,20.01251
230,72,82.81,571,624834,20.232397
220,56,83.09,578,625412,20.093084
60,12,82.29,92,625504,19.96172
160,48,82.21,500,626004,20.02584
280,74,82.63,652,626656,20.091312
190,68,82.79,617,627273,20.200634
210,64,82.95,857,628130,20.240974
340,104,83.59,732,628862,20.421038
710,172,84.55,1252,630114,20.355091
80,24,84.55,146,630260,20.292892
80,32,83.55,165,630425,20.361206
280,80,83.23,748,631173,20.469236
160,52,83.51,415,631588,20.374802
20,8,82.75,111,631699,20.255434
240,76,83.23,750,632449,20.518177
280,84,83.11,679,633128,20.508907
880,216,83.95,2284,635412,20.383223
360,104,84.27,777,636189,20.301222
160,48,84.35,512,636701,20.15384
60,24,83.11,262,636963,20.272572
280,78,83.25,722,637685,20.210619
630,88,83.81,698,638383,20.186663
790,96,83.98,830,639213,20.1459
290,84,84.18,863,640076,20.157526
450,76,83.54,729,640805,20.056782
540,76,83.5,582,641387,20.041418
620,160,83.7,942,642329,20.110256
480,72,82.9,456,642785,20.074642
300,84,83.38,731,643516,20.03263
30,8,83.38,134,643650,20.303349
150,52,83.3,443,644093,20.130157
290,80,82.82,618,644711,20.213343
260,80,82.98,632,645343,20.108568
370,104,83.38,646,645989,20.116993
120,48,83.02,269,646258,20.23347
380,112,83.5,583,646841,20.173248
280,80,83.34,492,647333,20.231354
460,129,84.39,782,648115,20.212397
760,184,85.51,1006,649121,20.253096
280,80,85.35,526,649647,20.220268
420,116,85.79,829,650476,20.35088
340,92,86.39,500,650976,20.422169
630,164,87.1,941,651917,20.45042
30,12,86.78,94,652011,20.471092
30,12,86.22,105,652116,20.456947
70,26,85.88,177,652293,20.745388
510,124,86.32,790,653083,20.513748
180,68,86.12,502,653585,20.739985
130,48,86.47,299,653884,20.637974
610,156,87.19,834,654718,20.698061
270,76,86.44,606,655324,20.597282
60,20,86.28,285,655609,20.525032
110,36,86.2,368,655977,20.592243
340,91,86.42,620,656597,20.690914
260,80,85.38,468,657065,20.689507
70,28,84.7,341,657406,20.58975
310,88,84.31,695,658101,20.626715
100,28,83.43,218,658319,20.653643
200,64,82.75,429,658748,20.680307
80,24,82.31,334,659082,20.742296
360,93,82.52,557,659639,20.733765
260,84,82.12,750,660389,20.737823
300,92,82.64,761,661150,20.71736
120,31,81.4,238,661388,20.795084
350,96,81.72,768,662156,20.758368
130,39,81.19,339,662495,20.984118
240,77,80.84,651,663146,20.82627
70,15,79.43,175,663321,20.897598
320,95,80.26,530,663851,20.737247
260,72,80.14,428,664279,20.780352
250,76,80.26,399,664678,20.747227
220,70,80.12,521,665199,20.810318
150,52,79.69,390,665589,20.6475
190,56,79.78,330,665919,20.838581
290,96,79.34,681,666600,20.696266
400,104,79.98,949,667549,20.784157
250,84,80.42,626,668175,20.694788
180,57,80.35,450,668625,20.792984
510,140,80.76,999,669624,20.718496
150,52,80.32,390,670014,20.883139
250,76,79.44,481,670495,20.833088
420,108,79.32,1003,671498,20.650457
210,60,78.88,736,672234,20.717169
230,68,79.08,449,672683,20.670862
280,68,78.0,637,673320,20.672743
270,76,77.4,692,674012,20.749912
460,120,76.84,1375,675387,20.68029
220,72,77.08,579,675966,20.595768
680,164,78.04,1645,677611,20.566137
530,144,77.68,1047,678658,20.49289
320,92,76.72,662,679320,20.50049
360,100,77.04,651,679971,20.595976
220,60,76.61,496,680467,20.52421
210,72,76.6,460,680927,20.542425
530,136,77.52,849,681776,20.509953
130,40,77.52,291,682067,20.434978
190,60,77.45,458,682525,20.623186
680,168,78.97,1106,683631,20.56549
50,20,78.07,186,683817,20.441622
110,32,77.59,212,684029,20.603825
120,40,77.27,374,684403,20.680239
250,84,77.55,642,685045,20.56229
110,44,77.87,496,685541,20.593458
230,76,78.15,443,685984,20.46855
80,24,77.65,221,686205,20.320524
610,152,78.49,884,687089,20.50952
160,52,78.37,619,687708,20.523949
290,80,78.13,664,688372,20.597586
70,28,76.69,312,688684,20.697733
280,84,77.29,597,689281,20.572294
120,36,77.33,207,689488,20.700066
40,16,76.69,153,689641,20.681656
270,92,77.09,817,690458,20.612392
520,132,78.33,1335,691793,20.744463
230,72,78.29,598,692391,20.778173
220,80,78.25,643,693034,20.613892
90,32,76.41,191,693225,20.537647
370,108,76.45,810,694035,20.769136
200,67,76.64,491,694526,20.767385
440,108,77.48,738,695264,20.749807
70,25,76.95,187,695451,20.566935
550,136,77.43,788,696239,20.806253
320,97,77.44,775,697014,20.835941
210,68,77.28,422,697436,20.844208
80,28,76.8,274,697710,20.834972
170,56,76.6,483,698193,20.72636
260,72,75.72,573,698766,20.846268
420,128,76.28,827,699593,20.724556
110,36,75.8,368,699961,20.869686
40,16,75.88,144,700105,20.654045
70,28,75.64,273,700378,20.945076
200,67,75.51,409,700787,20.892313
20,8,74.79,191,700978,20.943264
560,148,75.23,1180,702158,20.813047
100,28,75.03,256,702414,20.837746
230,64,74.55,394,702808,20.642126
160,56,74.31,462,703270,20.827663
170,52,73.54,556,703826,20.761353
280,68,72.38,470,704296,20.859009
410,106,72.64,834,705130,20.868769
440,120,72.68,790,705920,20.825594
240,71,72.47,515,706435,20.818254
150,56,71.39,411,706846,20.806812
320,84,72.11,790,707636,20.739134
430,120,73.19,871,708507,20.77585
420,112,74.05,718,709225,20.752768
570,145,74.26,1158,710383,20.739326
680,172,75.3,1245,711628,20.801767
160,52,75.34,342,711970,20.931015
210,60,74.38,463,712433,20.982971
180,56,74.18,450,712883,20.88506
30,12,74.1,124,713007,20.962814
390,96,74.7,850,713857,20.852325
100,24,74.03,195,714052,20.706814
290,89,74.12,587,714639,20.843157
610,155,75.39,978,715617,20.79945
540,132,75.83,842,716459,20.879597
270,72,76.27,542,717001,20.878725
150,45,76.08,266,717267,20.888159
80,23,76.07,222,717489,21.028505
340,96,76.1,677,718166,20.868132
160,56,75.82,319,718485,20.85104
330,92,75.82,737,719222,20.93051
210,61,76.12,542,719764,20.965492
170,44,75.6,464,720228,20.961933
210,64,75.85,442,720670,21.01924
400,92,76.0,572,721242,21.063822
380,100,76.85,781,722023,20.992382
230,72,76.62,571,722594,20.988058
300,84,76.74,804,723398,20.965254
360,104,77.02,639,724037,20.949774
150,52,76.84,529,724566,20.925438
490,124,77.56,968,725534,20.836166
550,144,78.44,1195,726729,20.911049
180,56,78.04,374,727103,20.967169
300,93,77.93,619,727722,20.969759
150,53,77.62,339,728061,20.926214
460,128,78.33,878,728939,20.91917
220,72,77.65,569,729508,20.868338
370,104,78.17,890,730398,20.952106
270,74,78.15,507,730905,21.091011
400,114,78.21,782,731687,20.979248
460,124,78.85,588,732275,20.906698
130,48,78.65,446,732721,20.97797
340,96,78.93,624,733345,21.030342
560,148,79.65,1134,734479,20.932013
100,39,78.84,219,734698,20.88103
270,76,78.88,504,735202,20.988518
250,80,78.04,521,735723,21.086857
290,84,77.44,682,736405,21.049704
610,154,78.06,838,737243,21.073452
50,16,77.22,205,737448,20.976171
280,81,77.43,682,738130,21.072172
560,144,78.15,894,739024,21.051039
170,48,77.27,522,739546,21.107666
230,64,77.51,443,739989,21.097048
130,44,77.35,436,740425,21.075846
670,168,77.35,1313,741738,21.114822
100,35,77.5,309,742047,21.176533
100,32,77.5,309,742356,21.253517
260,72,77.82,436,742792,21.192953
430,112,78.1,886,743678,21.259624
150,40,78.06,495,744173,21.175764
250,72,78.02,571,744744,21.224894
190,48,78.26,469,745213,21.072803
620,160,78.34,1256,746469,21.132732
130,40,78.22,263,746732,21.14625
290,80,78.22,502,747234,21.047152
290,92,78.86,718,747952,21.07783
90,28,78.3,216,748168,21.097647
420,120,79.14,985,749153,21.15604
210,56,79.54,531,749684,21.033087
340,96,79.58,696,750380,20.982668
20,8,78.34,108,750488,21.084118
260,88,78.5,675,751163,21.0809
160,44,78.14,455,751618,20.98373
460,112,78.94,1074,752692,20.958294
270,76,78.62,709,753401,20.95243
360,104,78.99,766,754167,20.929441
160,54,78.45,352,754519,20.77223
570,140,79.6,1261,755780,21.025295
100,32,78.56,168,755948,20.847422
140,40,77.99,325,756273,20.900543
430,124,78.55,982,757255,20.961796
90,36,78.63,225,757480,20.970951
130,48,78.55,367,757847,21.071674
80,27,78.1,181,758028,21.07884
290,88,77.7,458,758486,21.142057
110,40,77.74,332,758818,20.958817
620,160,79.18,1219,760037,21.080954
130,44,79.34,387,760424,20.93001
230,71,79.38,483,760907,21.039598
290,84,80.14,863,761770,21.064478
70,16,78.82,175,761945,21.086353
140,36,78.9,259,762204,20.975813
320,92,79.18,665,762869,20.996845
650,164,80.26,1447,764316,20.971716
60,24,79.98,254,764570,21.077215
400,112,80.42,933,765503,21.024647
260,76,80.12,754,766257,21.062124
80,28,79.2,304,766561,20.958271
270,84,79.33,931,767492,20.931572
210,72,79.49,459,767951,21.097067
370,104,79.69,1107,769058,21.057888
420,120,79.69,778,769836,21.02097
160,48,79.05,392,770228,21.168253
270,72,78.32,680,770908,21.021086
270,72,77.32,695,771603,21.075535
360,96,77.76,869,772472,21.04206
90,30,77.46,332,772804,21.020664
70,28,77.18,300,773104,20.975863
40,8,77.14,85,773189,21.196085
270,68,76.86,393,773582,21.075844
140,48,77.1,357,773939,21.095116
500,136,77.57,968,774907,21.04392
310,84,76.86,789,775696,21.114662
120,44,75.98,310,776006,21.021652
190,53,75.79,392,776398,21.156464
140,52,75.86,397,776795,21.066475
450,121,76.84,773,777568,21.071999
210,68,76.56,555,778123,21.129635
140,48,76.48,500,778623,21.125181
180,56,76.12,580,779203,21.07106
240,64,76.15,486,779689,21.031366
520,138,77.09,1303,780992,21.044197
150,49,76.94,471,781463,20.980974
210,64,76.66,422,781885,20.978247
320,85,76.51,709,782594,20.97486
470,132,77.11,1078,783672,20.99371
320,84,77.11,685,784357,21.013948
150,44,76.51,433,784790,21.092342
360,92,76.91,627,785417,21.03607
250,72,76.39,552,785969,20.900599
230,76,75.71,726,786695,21.009542
540,136,76.51,932,787627,20.901026
340,96,76.54,844,788471,20.926924
290,88,76.89,952,789423,21.000708
620,157,77.18,1258,790681,21.00185
310,92,77.38,785,791466,21.12204
580,152,77.86,963,792429,21.234715
370,96,78.08,548,792977,21.263554
110,24,77.18,247,793224,21.258608
190,54,76.48,342,793566,21.280449
180,56,76.56,477,794043,21.312197
260,76,76.36,623,794666,21.427326
250,80,75.68,557,795223,21.358892
540,141,76.7,1110,796333,21.361338
380,108,77.02,855,797188,21.241425
140,51,76.73,434,797622,21.379314
60,24,76.13,207,797829,21.263033
390,104,75.63,911,798740,21.348093
140,42,75.89,515,799255,21.380613
140,36,75.44,270,799525,21.272627
530,140,75.4,928,800453,21.250628
610,153,76.45,1170,801623,21.233364
450,116,76.97,1290,802913,21.213074
230,68,77.21,841,803754,21.244698
470,132,76.85,1101,804855,21.136765
270,68,77.18,697,805552,21.068588
230,68,77.54,457,806009,21.106335
400,105,77.87,1027,807036,21.103064
80,19,76.94,238,807274,21.1463
410,116,77.7,1468,808742,21.12641
690,172,78.7,1825,810567,21.038607
90,28,78.5,470,811037,20.830004
310,84,77.74,664,811701,20.960442
180,60,77.94,456,812157,20.80748
320,92,78.06,655,812812,20.884026
360,104,78.18,675,813487,20.983335
210,72,78.62,636,814123,21.001534
550,144,78.86,1047,815170,20.941395
660,168,79.98,1556,816726,21.085884
520,144,80.46,1145,817871,21.042433
650,160,81.98,1461,819332,21.030851
260,80,81.9,662,819994,21.092192
450,120,82.66,923,820917,21.090216
220,62,82.16,555,821472,21.139908
420,120,82.6,874,822346,21.130648
130,44,82.0,452,822798,21.056084
80,28,81.74,285,823083,21.163149
310,88,81.22,676,823759,21.167364
250,76,81.66,473,824232,21.177414
20,8,81.34,64,824296,20.904541
730,180,81.9,1508,825804,21.131495
630,160,83.14,1659,827463,21.167948
380,104,83.7,880,828343,21.143595
520,140,84.83,1011,829354,21.044464
380,108,85.03,715,830069,21.054213
460,122,85.85,1078,831147,21.185076
380,116,85.41,662,831809,21.135447
260,80,85.77,695,832504,21.153984
390,104,86.1,789,833293,21.098934
370,109,86.35,689,833982,21.121134
290,82,87.01,532,834514,21.196835
150,44,87.09,268,834782,21.210043
340,100,87.17,745,835527,21.128288
170,44,85.97,462,835989,21.23174
120,44,86.17,421,836410,21.181843
120,48,85.53,345,836755,21.133158
300,92,85.69,740,837495,21.148016
90,32,85.73,260,837755,21.154722
50,20,85.09,179,837934,21.345898
80,28,84.65,339,838273,21.04344
400,104,84.65,878,839151,21.136452
520,144,84.89,1068,840219,21.134483
310,92,85.33,667,840886,21.245895
150,48,85.09,445,841331,21.2354
360,104,85.41,951,842282,21.256735
380,108,85.53,907,843189,21.281
110,44,85.67,484,843673,21.271404
400,105,86.44,1027,844700,21.19901
170,45,86.81,416,845116,21.183218
100,36,86.49,213,845329,21.276472
480,128,87.29,900,846229,21.185379
530,144,87.37,1126,847355,21.221123
250,80,87.33,560,847915,21.208466
250,80,87.69,639,848554,21.19969
500,132,88.48,1439,849993,21.154549
60,20,88.16,276,850269,21.096613
290,88,87.83,658,850927,21.215002
160,44,87.59,213,851140,21.359444
150,51,87.62,265,851405,21.237825
280,92,87.98,695,852100,21.221785
500,124,88.58,754,852854,21.284657
460,128,88.48,837,853691,21.318884
80,28,88.27,180,853871,21.339203
160,40,88.03,371,854242,21.243906
230,80,87.98,766,855008,21.321978
140,50,87.16,354,855362,21.240005
130,48,86.8,468,855830,21.278566
490,136,87.72,832,856662,21.274227
200,60,87.4,433,857095,21.426182
600,144,88.12,1250,858345,21.401129
230,56,87.92,399,858744,21.457039
330,96,87.52,577,859321,21.357513
490,124,87.8,830,860151,21.390554
330,92,87.84,690,860841,21.427073
150,48,86.75,356,861197,21.45374
550,144,87.27,1104,862301,21.509438
390,107,86.82,802,863103,21.52431
220,64,86.5,591,863694,21.336401
390,112,87.38,962,864656,21.492752
80,32,87.16,263,864919,21.624054
310,80,87.4,747,865666,21.47903
160,52,87.16,512,866178,21.350498
260,76,87.12,748,866926,21.322151
110,42,86.13,195,867121,21.28426
200,52,85.57,590,867711,21.381008
160,52,85.58,513,868224,21.301395
340,91,86.25,817,869041,21.34055
150,48,85.69,464,869505,21.251284
690,172,86.99,1405,870910,21.264673
150,44,87.07,456,871366,21.135168
390,108,86.75,877,872243,21.073635
280,72,85.94,683,872926,21.089695
140,48,85.26,584,873510,21.045437
210,64,85.22,820,874330,21.042204
380,110,85.0,806,875136,21.095339
150,52,84.84,542,875678,21.182245
120,44,84.6,381,876059,21.041517
310,92,84.47,546,876605,21.053024
490,129,85.57,810,877415,21.11619
190,56,84.97,389,877804,21.197046
230,76,84.01,644,878448,21.19345
710,172,85.45,1542,879990,21.233763
520,137,85.98,856,880846,21.235191
390,108,86.46,904,881750,21.221235
140,48,86.02,333,882083,21.304726
130,40,85.38,330,882413,21.186089
260,72,85.38,506,882919,21.195087
170,60,84.54,402,883321,21.280565
90,36,83.22,288,883609,21.333841
280,88,82.66,567,884176,21.350298
170,52,81.58,465,884641,21.30218
160,56,81.34,345,884986,21.462095
340,100,81.14,798,885784,21.361656
350,100,81.52,724,886508,21.38106
440,112,81.44,899,887407,21.415827
100,32,81.32,346,887753,21.481709
330,91,81.95,709,888462,21.32383
440,114,82.21,879,889341,21.417204
140,40,81.85,577,889918,21.393198
450,110,82.87,882,890800,21.335907
310,88,81.95,671,891471,21.339582
30,12,80.47,136,891607,21.340996
110,40,79.83,318,891925,21.339277
40,16,78.59,247,892172,21.331213
380,108,78.59,719,892891,21.346348
250,76,78.13,767,893658,21.428637
350,92,77.89,670,894328,21.406643
350,90,77.99,637,894965,21.466644
330,96,77.91,780,895745,21.258814
240,76,77.58,512,896257,21.311367
410,112,77.88,861,897118,21.298662
460,128,78.72,1069,898187,21.289965
310,92,78.64,637,898824,21.261879
530,140,79.6,839,899663,21.149809
100,36,79.52,360,900023,21.334776
220,71,79.75,656,900679,21.36895
150,52,79.35,522,901201,21.281305
120,44,79.47,355,901556,21.170156
200,68,79.95,542,902098,21.241135
50,20,79.87,259,902357,21.279737
110,36,79.19,268,902625,21.221008
350,94,78.69,629,903254,21.316519
330,92,78.69,706,903960,21.364965
140,36,78.57,390,904350,21.294
120,36,77.89,264,904614,21.332989
200,52,77.33,467,905081,21.33958
270,76,77.65,708,905789,21.384579
630,148,78.08,1069,906858,21.34776
240,68,78.31,566,907424,21.329796
370,112,79.07,719,908143,21.356558
60,24,78.03,258,908401,21.335821
490,140,77.99,848,909249,21.400969
250,76,77.95,520,909769,21.356419
470,134,78.49,1131,910900,21.54363
40,16,77.33,150,911050,21.571478
410,120,78.33,693,911743,21.622923
330,96,78.41,876,912619,21.536188
120,40,78.37,418,913037,21.767218
200,72,78.58,618,913655,21.620417
300,85,78.51,629,914284,21.675
280,80,78.07,708,914992,21.656324
450,120,77.99,1040,916032,21.612535
190,60,78.31,621,916653,21.525494
550,144,79.35,1014,917667,21.542017
250,72,79.27,476,918143,21.486969
360,104,79.81,740,918883,21.554087
80,32,79.65,352,919235,21.48858
580,156,79.85,1136,920371,21.560797
510,136,80.61,1055,921426,21.574797
350,104,80.21,713,922139,21.566525
320,95,80.6,605,922744,21.643436
290,84,80.48,657,923401,21.614462
220,60,79.84,579,923980,21.540817
270,84,79.76,926,924906,21.506222
150,42,79.7,408,925314,21.381489
280,92,79.18,797,926111,21.545135
630,164,79.75,1246,927357,21.572626
110,40,79.51,303,927660,21.515814
270,68,79.07,696,928356,21.509356
70,28,79.03,279,928635,21.392338
300,88,79.11,782,929417,21.563442
340,100,79.59,851,930268,21.584723
640,164,80.47,1258,931526,21.611225
70,28,80.33,386,931912,21.525175
380,100,80.81,707,932619,21.509434
270,84,81.13,745,933364,21.563457
340,92,81.14,693,934057,21.51534
300,84,81.5,742,934799,21.550644
200,48,80.26,487,935286,21.461275
340,92,80.74,887,936173,21.570251
60,20,79.86,170,936343,21.429743
20,8,79.22,90,936433,21.53683
160,52,79.26,477,936910,21.46235
390,116,79.78,792,937702,21.517988
50,19,78.87,116,937818,21.330133
650,163,79.98,1038,938856,21.446354
360,94,80.48,603,939459,21.481716
230,67,80.23,438,939897,21.593866
320,92,79.86,678,940575,21.45937
170,48,79.78,403,940978,21.456367
230,65,79.67,414,941392,21.448034
160,56,78.51,670,942062,21.506865
570,144,78.58,922,942984,21.578333
340,103,78.53,797,943781,21.541592
530,132,79.37,937,944718,21.544407
340,97,79.94,633,945351,21.638393
270,92,80.14,611,945962,21.659859
320,88,80.42,1014,946976,21.587109
450,120,81.26,834,947810,21.592592
150,44,80.82,349,948159,21.610891
100,28,80.58,320,948479,21.661915
120,40,80.42,406,948885,21.669065
460,124,80.66,1023,949908,21.65513
380,104,80.7,1048,950956,21.686821
220,76,80.34,594,951550,21.66544
160,48,80.5,308,951858,21.51452
710,176,81.35,1439,953297,21.681278
270,84,81.05,641,953938,21.573938
260,72,81.37,647,954585,21.663538
150,48,80.75,473,955058,21.621458
220,64,80.51,434,955492,21.599155
280,68,81.07,670,956162,21.564856
140,45,81.12,235,956397,21.52567
190,55,81.51,507,956904,21.636623
390,112,81.55,916,957820,21.528975
240,60,81.39,614,958434,21.614285
370,96,81.43,811,959245,21.650412
290,80,81.33,869,960114,21.543526
190,56,80.93,580,960694,21.536129
210,68,80.85,597,961291,21.471407
150,52,80.25,313,961604,21.558504
180,56,79.53,316,961920,21.377878
110,32,78.93,211,962131,21.684486
630,164,79.17,1007,963138,21.597744
200,68,79.49,409,963547,21.59974
260,76,79.54,427,963974,21.49397
40,4,79.06,136,964110,21.68126
140,48,79.1,357,964467,21.572626
100,40,78.82,338,964805,21.522137
330,88,79.5,573,965378,21.67462
570,138,80.52,948,966326,21.635117
460,128,80.86,864,967190,21.692966
40,13,80.07,184,967374,21.550055
180,60,80.31,507,967881,21.756903
500,144,81.39,876,968757,21.60129
80,32,81.19,189,968946,21.716833
320,83,81.26,525,969471,21.712393
230,64,80.42,481,969952,21.740482
210,67,80.41,463,970415,21.749508
260,72,80.01,496,970911,21.70768
320,87,80.64,653,971564,21.680473
120,48,79.72,354,971918,21.71056
50,12,79.08,134,972052,21.71726
190,60,78.34,584,972636,21.844313
360,96,79.14,654,973290,21.709574
220,72,78.66,447,973737,21.673857
200,56,78.26,338,974075,21.695858
560,138,79.24,1221,975296,21.774652
550,148,80.0,1085,976381,21.678904
170,56,79.71,414,976795,21.686155
260,84,79.75,625,977420,21.619522
80,32,78.87,252,977672,21.581278
70,23,78.5,176,977848,21.745646
190,56,77.62,455,978303,21.734818
270,80,77.7,752,979055,21.619522
200,70,77.36,558,979613,21.63068
70,28,77.32,183,979796,21.590467
500,140,77.16,816,980612,21.763145
130,40,76.2,230,980842,21.792454
170,44,75.6,310,981152,21.837431
340,96,75.61,710,981862,21.797853
710,172,76.49,1215,983077,21.832394
80,30,76.19,222,983299,21.798119
320,96,76.31,519,983818,21.812174
160,48,76.37,253,984071,21.885572
400,108,76.53,703,984774,21.864122
240,72,75.61,576,985350,21.86674
280,88,76.09,765,986115,21.810825
70,22,75.63,274,986389,21.72205
380,100,76.35,665,987054,21.839483
430,120,76.67,795,987849,21.850903
450,120,76.87,794,988643,21.915956
350,86,76.09,523,989166,21.96793
450,120,77.01,777,989943,21.99803
190,56,76.57,348,990291,21.919426
670,168,77.41,1095,991386,21.930447
170,56,77.05,504,991890,21.996191
220,68,76.89,565,992455,22.090794
180,56,76.97,365,992820,22.04567
290,92,76.97,503,993323,22.04442
70,28,77.05,228,993551,21.913052
640,160,78.57,1064,994615,21.963587
80,28,78.33,170,994785,22.01206
630,154,78.71,1146,995931,21.99198
640,164,80.16,1204,997135,21.97754
40,16,78.69,182,997317,22.021122
280,76,78.51,527,997844,21.97942
260,72,78.56,439,998283,21.911348
320,86,78.5,542,998825,22.048553
70,20,78.22,177,999002,21.894247
640,164,79.21,937,999939,22.125523
40,16,78.81,282,1000221,22.205982
380,92,78.29,612,1000833,22.098991
140,48,77.74,561,1001394,22.169153
630,160,78.02,1053,1002447,22.061789
270,80,77.85,523,1002970,22.127806
390,124,78.17,881,1003851,22.113003
240,54,77.83,348,1004199,22.13402
310,100,77.63,710,1004909,22.121342
120,44,77.63,407,1005316,22.093212
350,96,78.31,536,1005852,22.138563
210,60,78.51,303,1006155,22.111603
150,56,77.83,459,1006614,22.113102
140,46,77.25,255,1006869,22.014145
90,32,76.81,200,1007069,22.130623
450,112,77.45,755,1007824,22.07768
240,69,76.38,473,1008297,22.027298
320,88,76.42,436,1008733,21.985985
550,136,77.06,794,1009527,22.066013
230,64,77.22,465,1009992,21.958052
440,121,77.79,891,1010883,21.82255
70,28,77.39,332,1011215,21.784912
390,108,78.02,987,1012202,21.842974
80,28,77.75,282,1012484,21.813103
240,76,77.39,538,1013022,21.749697
100,28,77.07,282,1013304,21.803837
250,72,76.83,586,1013890,21.86444
260,76,76.79,675,1014565,21.813728
170,52,76.75,445,1015010,21.740858
330,92,76.99,564,1015574,21.88077
280,68,77.15,468,1016042,21.676044
250,80,77.39,457,1016499,21.799252
160,60,77.67,457,1016956,21.801123
250,72,76.75,481,1017437,21.798475
80,24,76.31,296,1017733,21.684656
390,108,76.63,636,1018369,21.745136
420,112,77.71,700,1019069,21.778624
690,164,78.87,1347,1020416,21.72948
370,108,79.55,670,1021086,21.66222
70,25,78.92,340,1021426,21.72609
260,88,78.42,790,1022216,21.678835
110,40,77.54,378,1022594,21.687384
210,72,78.13,404,1022998,21.528233
80,32,77.85,269,1023267,21.73781
130,44,76.85,430,1023697,21.753725
280,94,77.47,503,1024200,21.665703
350,104,77.68,739,1024939,21.680998
240,68,77.72,449,1025388,21.586285
180,60,77.65,512,1025900,21.643644
70,24,77.17,167,1026067,21.637812
310,96,77.26,768,1026835,21.708822
60,16,76.94,171,1027006,21.77105
420,112,77.94,921,1027927,21.691345
210,60,77.94,512,1028439,21.652699
430,120,78.18,782,1029221,21.705908
160,52,77.98,371,1029592,21.709526
210,68,78.1,527,1030119,21.581701
170,52,77.24,405,1030524,21.613453
370,104,76.8,769,1031293,21.612255
140,36,76.6,501,1031794,21.627342
80,28,76.04,352,1032146,21.530287
240,76,76.48,450,1032596,21.61082
350,96,77.21,732,1033328,21.63799
740,180,78.45,1660,1034988,21.584105
170,56,78.21,412,1035400,21.617273
60,24,77.75,272,1035672,21.604345
200,68,78.15,431,1036103,21.542995
530,140,78.15,735,1036838,21.634413
250,76,78.51,413,1037251,21.683907
130,40,78.47,233,1037484,21.615105
370,112,78.63,626,1038110,21.624521
540,144,78.35,1058,1039168,21.592022
290,88,78.93,447,1039615,21.592655
110,36,78.33,291,1039906,21.7358
310,92,78.77,797,1040703,21.660372
70,28,77.97,304,1041007,21.671753
40,16,77.41,152,1041159,21.54103
360,100,77.53,784,1041943,21.591726
70,24,77.55,154,1042097,21.638092
300,88,77.43,776,1042873,21.723545
370,108,77.31,991,1043864,21.690048
500,131,77.42,1177,1045041,21.67361
110,44,77.0,369,1045410,21.66039
400,112,76.92,950,1046360,21.57715
680,168,78.04,1331,1047691,21.655058
140,44,76.8,426,1048117,21.736897
350,92,77.16,739,1048856,21.67901
260,73,77.21,552,1049408,21.687908
380,108,77.73,733,1050141,21.575266
150,52,77.33,477,1050618,21.81169
170,56,77.61,349,1050967,21.70085
90,32,76.33,410,1051377,21.681002
200,68,76.73,643,1052020,21.636093
250,80,75.99,554,1052574,21.702059
400,116,75.51,838,1053412,21.659672
330,84,76.19,671,1054083,21.605392
360,104,76.47,687,1054770,21.603998
90,32,76.07,230,1055000,21.719872
120,44,75.65,378,1055378,21.546406
200,65,76.1,529,1055907,21.584253
200,60,75.06,544,1056451,21.634228
260,76,75.66,611,1057062,21.66233
400,112,75.86,743,1057805,21.662806
120,35,75.73,382,1058187,21.537306
420,112,75.25,972,1059159,21.626268
110,36,74.81,336,1059495,21.529785
330,96,74.53,607,1060102,21.548483
370,92,74.91,736,1060838,21.661499
110,44,74.35,333,1061171,21.631296
130,48,74.39,500,1061671,21.762047
360,112,74.55,639,1062310,21.70558
60,24,74.19,244,1062554,21.597708
700,167,75.3,922,1063476,21.649364
570,156,76.4,1031,1064507,21.722004
240,76,76.84,538,1065045,21.682745
310,85,76.57,614,1065659,21.757812
230,72,76.6,564,1066223,21.767685
970,248,78.2,1607,1067830,21.732597
620,128,78.12,899,1068729,21.803936
1210,152,79.0,1232,1069961,21.759071
620,96,78.75,522,1070483,21.650482
260,84,79.31,534,1071017,21.607319
180,52,78.75,377,1071394,21.68429
210,67,79.14,417,1071811,21.751663
70,28,78.66,248,1072059,21.63536
300,80,79.18,656,1072715,21.680431
370,84,79.3,484,1073199,21.688194
510,140,79.94,714,1073913,21.706017
250,68,80.1,524,1074437,21.782757
290,80,79.98,469,1074906,21.655718
60,23,79.53,127,1075033,21.423187
100,32,79.05,271,1075304,21.637094
280,84,79.29,503,1075807,21.6062
700,172,80.29,1189,1076996,21.64744
160,52,80.57,395,1077391,21.583294
420,128,80.77,991,1078382,21.670792
230,71,80.36,406,1078788,21.652224
200,64,79.36,406,1079194,21.652912
190,56,78.84,387,1079581,21.62696
290,82,79.41,544,1080125,21.524782
670,160,80.13,1260,1081385,21.544823
240,72,80.45,529,1081914,21.46866
330,96,80.69,650,1082564,21.531895
150,51,80.88,451,1083015,21.575857
360,104,81.48,794,1083809,21.57116
240,68,81.22,502,1084311,21.530678
160,48,80.66,422,1084733,21.496613
550,140,81.38,1347,1086080,21.520132
250,65,81.43,415,1086495,21.435852
160,42,81.61,563,1087058,21.509794
120,36,81.01,328,1087386,21.493446
150,44,81.29,315,1087701,21.517616
380,116,81.33,906,1088607,21.410679
320,96,81.69,945,1089552,21.518375
240,76,81.25,485,1090037,21.455772
600,155,82.28,1055,1091092,21.314106
290,80,82.4,594,1091686,21.386276
60,24,82.12,261,1091947,21.453833
140,48,81.56,326,1092273,21.440931
220,64,81.84,510,1092783,21.401922
510,132,82.88,1225,1094008,21.373463
180,52,82.64,459,1094467,21.41018
300,87,82.55,701,1095168,21.328499
80,32,81.07,365,1095533,21.378748
300,80,81.31,852,1096385,21.329498
280,76,81.83,868,1097253,21.414045
160,54,81.69,497,1097750,21.332554
80,32,80.61,248,1097998,21.32996
340,84,80.69,859,1098857,21.43913
100,32,80.61,178,1099035,21.578543
540,140,80.89,924,1099959,21.42051
370,100,80.45,622,1100581,21.400883
270,87,80.44,642,1101223,21.40692
360,100,81.08,686,1101909,21.418043
330,96,81.12,567,1102476,21.385996
130,43,81.27,444,1102920,21.418661
150,44,81.55,281,1103201,21.347336
200,52,81.07,521,1103722,21.36658
600,144,82.27,1120,1104842,21.349358
400,112,82.51,792,1105634,21.400982
180,48,81.91,449,1106083,21.370882
90,28,80.88,241,1106324,21.405495
170,52,80.96,465,1106789,21.397364
30,12,79.96,217,1107006,21.363447
400,112,79.4,1061,1108067,21.388744
360,104,80.0,970,1109037,21.38344
400,104,80.12,1026,1110063,21.438284
70,22,79.61,212,1110275,21.4468
460,124,79.77,971,1111246,21.5261
230,80,80.05,647,1111893,21.510977
320,96,80.45,776,1112669,21.52147
60,24,80.37,185,1112854,21.502338
200,64,80.33,668,1113522,21.447248
120,40,79.93,272,1113794,21.413065
470,132,80.09,898,1114692,21.445469
320,92,80.17,515,1115207,21.361036
200,72,79.85,478,1115685,21.42092
440,128,80.81,992,1116677,21.455542
330,100,81.37,732,1117409,21.49156
370,94,81.66,800,1118209,21.40291
370,84,81.9,700,1118909,21.43262
170,48,81.62,384,1119293,21.466974
330,90,81.4,687,1119980,21.42349
180,64,81.69,491,1120471,21.556568
190,64,81.21,531,1121002,21.577585
620,160,82.45,1130,1122132,21.513956
520,140,82.89,926,1123058,21.625278
530,144,83.41,1068,1124126,21.685343
250,68,83.65,547,1124673,21.637514
150,38,83.55,234,1124907,21.637924
350,95,83.38,732,1125639,21.721746
340,96,84.1,701,1126340,21.610634
300,84,83.27,663,1127003,21.578636
110,44,82.15,329,1127332,21.631264
150,48,81.87,323,1127655,21.603163
170,64,81.66,501,1128156,21.721386
640,164,82.58,1114,1129270,21.61088
260,84,80.94,580,1129850,21.653284
430,112,80.78,872,1130722,21.609753
250,68,79.94,532,1131254,21.642094
380,108,80.06,831,1132085,21.663568
270,68,79.9,667,1132752,21.60676
500,124,80.62,1376,1134128,21.703764
260,73,80.68,741,1134869,21.661097
210,64,81.04,589,1135458,21.623573
150,46,80.7,247,1135705,21.60901
370,99,80.85,798,1136503,21.576584
150,44,79.89,468,1136971,21.631527
350,100,80.21,917,1137888,21.555641
180,56,79.97,511,1138399,21.544558
310,92,80.66,731,1139130,21.599226
270,84,81.18,509,1139639,21.575495
120,42,80.76,313,1139952,21.495766
140,39,79.43,378,1140330,21.65799
730,180,80.71,1260,1141590,21.551115
480,136,80.79,891,1142481,21.619753
350,108,81.16,694,1143175,21.51476
80,20,80.72,104,1143279,21.7513
100,32,80.48,316,1143595,21.699358
50,19,79.85,246,1143841,21.607374
180,48,78.73,294,1144135,21.63748
210,62,78.63,512,1144647,21.540054
710,180,79.47,1274,1145921,21.576895
430,115,80.11,840,1146761,21.632055
280,80,79.87,610,1147371,21.71302
220,68,79.87,457,1147828,21.610462
140,40,79.79,501,1148329,21.658422
260,84,79.23,609,1148938,21.565964
60,20,78.78,197,1149135,21.78197
370,108,79.44,863,1149998,21.640167
150,40,79.48,346,1150344,21.569307
590,148,80.52,1382,1151726,21.537708
270,88,80.24,663,1152389,21.526506
270,72,80.0,552,1152941,21.720144
100,32,79.56,286,1153227,21.583824
510,124,79.25,1519,1154746,21.54477
400,104,79.49,824,1155570,21.551113
100,36,79.61,369,1155939,21.51241
140,48,79.61,457,1156396,21.50991
170,60,79.57,384,1156780,21.40095
400,100,79.25,800,1157580,21.456455
330,92,79.65,610,1158190,21.525679
290,92,79.7,526,1158716,21.468401
210,48,79.86,281,1158997,21.392426
130,36,79.42,338,1159335,21.522024
210,57,79.23,596,1159931,21.44898
340,88,79.57,687,1160618,21.549906
80,32,79.57,237,1160855,21.370626
160,48,79.21,332,1161187,21.447336
110,36,79.25,309,1161496,21.59931
240,76,78.61,614,1162110,21.550213
250,77,78.38,605,1162715,21.555098
340,100,78.51,760,1163475,21.637701
290,88,78.39,526,1164001,21.455357
50,20,77.63,225,1164226,21.555296
120,44,77.64,373,1164599,21.437065
280,92,78.12,698,1165297,21.35251
170,48,78.08,504,1165801,21.439362
580,152,78.16,1148,1166949,21.495155
190,52,77.56,326,1167275,21.550055
270,84,77.92,628,1167903,21.595373
70,24,77.88,344,1168247,21.601442
270,80,78.16,783,1169030,21.50175
590,139,79.43,953,1169983,21.493284
70,28,78.59,284,1170267,21.320408
450,120,78.75,987,1171254,21.433973
180,56,78.27,534,1171788,21.462975
220,68,78.73,540,1172328,21.395327
310,88,78.37,641,1172969,21.38213
370,100,78.57,852,1173821,21.382744
240,60,78.21,489,1174310,21.410528
290,72,78.69,455,1174765,21.483541
300,76,78.81,752,1175517,21.407148
390,112,79.53,1014,1176531,21.328873
350,96,79.17,760,1177291,21.305214
180,52,78.77,531,1177822,21.282192
270,76,78.81,590,1178412,21.33509
570,143,78.96,929,1179341,21.422962
90,32,78.28,204,1179545,21.355503
280,84,78.18,784,1180329,21.193651
90,32,77.66,206,1180535,21.262497
270,78,77.96,575,1181110,21.273874
140,36,77.42,440,1181550,21.234358
80,32,77.1,182,1181732,21.237444
430,120,77.66,1252,1182984,21.180643
30,8,76.14,55,1183039,21.184752
390,109,75.83,968,1184007,21.166588
